1111111111111111111111111111111111111111
1P00000000000000000000000000000000000001
1111111111111110001111011111111111111101
100C00000000000011111101C000000000011101
1111111111111100000000011111111111001101
1000000000000000000001111111111111100101
1000000000000000111111111111111111110001
1000000000011111111111111111111111111111
1001010000000000000000000000000000111001
1001011111000000000000000000000000111001
101001C111000000000111111111111001100001
11001101110000000010000000C0001001C01101
1C01110110000000010000000000110100101001
1110000100000000110011111111010100101001
10000111000000010010000000000001E1001001
10101101100000100111111111111100110010C1
1110110011000001000000000000001000011111
1100111001111100111111111110000111000001
1101111000000000000000000000000000000001
1000000000000000000000000000000000000001
1111111111111111111111111111111111111111